width = 5632
height = 2304

max_provinces = 8741
sea_starts = {
	1252 1254 1255 1256 1257 1258 1259 1261 1262 1263 1264 1265 1266 1267 1268 1269 1270 1271 1272 1274 1275 1276 1277 1278 1279 
	1280 1281 1282 1283 1284 1285 1286 1287 1288 1289 1290 1291 1292 1293 1294 1295 1296 1297 1298 1299 1300 1301 1302 1303 1304 
	1305 1307 1308 1309 1310 1311 1312 1313 1314 1315 1316 1317 1319 1320 1321 1322 1323 1324 1326 1328 1329 1330 1331 1332 1333 
	1334 1335 1336 1337 1338 1339 1340 1341 1342 1343 1344 1345 1346 1347 1348 1349 1350 1351 1352 1353 1354 1355 1356 1357 1358 
	1359 1360 1361 1362 1363 1364 1365 1366 1367 1368 1369 1370 1371 1372 1373 1374 1375 1376 1377 1378 1379 1380 1381 1382 1383 
	1384 1385 1386 1387 1388 1389 1390 1391 1392 1393 1394 1395 1396 1397 1398 1399 1400 1401 1402 1403 1404 1405 1406 1407 1408 
	1409 1410 1411 1412 1413 1414 1415 1416 1417 1418 1419 1420 1421 1422 1423 1424 1425 1426 1427 1428 1429 1430 1431 1432 1433 
	1434 1435 1436 1437 1438 1439 1440 1441 1442 1443 1444 1445 1446 1447 1448 1449 1450 1451 1452 1453 1454 1455 1456 1457 1458 
	1459 1460 1461 1462 1463 1464 1465 1466 1467 1468 1469 1470 1471 1472 1473 1474 1475 1476 1477 1478 1479 1480 1481 1482 1483 
	1484 1485 1486 1487 1488 1489 1490 1491 1492 1493 1494 1495 1496 1497 1498 1499 1500 1501 1502 1503 1504 1505 1506 1507 1508 
	1509 1510 1511 1512 1513 1514 1515 1516 1517 1518 1519 1520 1521 1522 1523 1524 1525 1526 1527 1528 1529 1530 1531 1532 1533 
	1534 1535 1536 1537 1538 1539 1540 1541 1542 1543 1544 1545 1546 1547 1548 1549 1550 1551 1552 1553 1554 1555 1556 1557 1558 
	1559 1560 1561 1562 1563 1564 1565 1566 1567 1568 1569 1570 1571 1572 1573 1574 1575 1576 1577 1578 1579 1580 1581 1582 1583 
	1584 1585 1586 1587 1588 1589 1590 1591 1592 1593 1594 1595 1596 1597 1598 1599 1600 1601 1602 1603 1604 1605 1606 1607 1608 
	1609 1610 1611 1612 1613 1614 1615 1616 1617 1618 1619 1620 1621 1622 1623 1624 1625 1626 1627 1628 1629 1630 1631 1632 1633 
	1634 1635 1636 1637 1638 1639 1640 1641 1642 1643 1644 1645 1646 1647 1652 1655 1659 1660 1661 1662 1663 1666 1667 1668 1669 
	1670 1671 1672 1673 1674 1675 1676 1677 1678 1679 1680 1681 1682 1683 1684 1685 1686 1687 1688 1689 1690 1691 1692 1693 1694 
	1695 1696 1697 1698 1699 1700 1701 1702 1703 1704 1705 1706 1707 1708 1709 1710 1711 1712 1713 1714 1715 1716 1717 1718 1719 
	1720 1721 1722 1723 1724 1725 1726 1727 1728 1729 1730 1731 1732 1733 1734 1735 1736 1737 1738 1739 1740 1741 1895 1896 1897 
	1898 1924 1926 1927 1928 1929 1932 1975 1977 1980 5107 5200 5201 5207 5208 5209 5227 5499 6925 6926 6986 6987 6988 6989 
	6990 6991 6992 6993 6994 6995 6996 6997 7280 7281 7282 7283 7284 7285 7286 7287 7288 7289 7290 7291 7292 7293 7294 7295 7297 
	7298 7299 7300 7301 7302 7303 7304 7305 7306 7307 7308 7309 7310 7311 7312 7313 7321 7322 7323 7324 7325 7326 7327 7328 7329 
	7330 7331 7332 7333 7334 7335 7336 7337 7338 7339 7340 7341 7342 7343 7344 7345 7346 7347 7348 7349 7350 7351 7352 7354 7355 
	7356 7377 7385 7386 7387 7388 7389 7390 7391 7392 7393 7394 7395 7396 7397 7398 7399 7400 7401 7402 7403 7404 7405 7406 7407 
	7408 7409 7410 7411 7412 7413 7414 7415 7885 7886 7887 7888 8311 8312 8313 8314 8315 8316 8317 8318 8319 8326 8327 8328 8329 
	8330 8331 8332 8333 8334 8335 8336 8337 8338 8339 8340 8342 8343 8344 8345 8346 8347 8348 8349 8350 8351 8352 8353 8354 8355 
	8356 8357 8358 8359 8360 8361 8362 8363 8364 8365 8366 8367 8368 8369 8370 8371 8372 8373 8374 8375 8376 8379 8380 8381 8382 
	8383 8384 8385 8386 8387 8388 8389 8390 8391 8392 8393 8394
	#HR's BtP provinces
	#3004 3005 3006 3007 3008 3009 3010 3011 3012 3013 3014 3015 3016 3017 3018 3019 3020 3021 3022 3023 3024 3025 3026 3027
	#3028 3029 3030 3031 3032 3033 3034 3035 3036 3037 3038 3041 3043 3044 3047 3049 3052
	#3053 3056 3057 3059 3061 3062 3065 3066 3067 3068 3070 3071 3072 3073 3074 3075 3076 3077
	#3078 3079 3080 3081 3082 3083 3084 3085 3086 3087 3088 3089 3090 3091 3093 3094 3096 3097 3098 3100 3101 3102
	#3103 3105 3106 3107 3109 3110 3111 3112 3113 3116 3125 3126 3127
	#3129 3130 3131 3132 3133 3136 3137 3138 3139 3140 3141 3143 3144 3145 3147 3149 3150
	#3153 3155 3156 3158 3161 3162 3163 3166 3171 3172 3173 3176
	#3184 3186 3188 3189
	#New in 1.2x
	4224 4225 4226 4233 4234 4333 4346 4357 4358
	
	#New VU Additions by San Felipe
	6148 6149 6150 6151 6152 6153 6154 6155 6156 6157 6158 6159 6160 6161 6162 6163 6164 6165 6166 6167 6168 6169 6170 6171 6172 
	6173 6220 6225 6227 6228 6231 6232 6236 6237 6238 6239 6293 6294 6295 6296 6297 6298 6299 6300 6301 6302 6303 6304 6305 6306 
	6307 6308 6309 6310 6311 6312 6313 6314 6315 6316 6317 6318 6319 6320 6321 6322 6323 6324 6325 6326 6327 6328 6329 6330 6331 
	6332 6333 6334 6335 6336 6337 6338 6339 6340 6341 6342 6343 6344 6345 6346 6347 6348 6349 6350 6351 6352 6353 6354 6355 6356 
	6357 6358 6359 6360 6361 6362 6363 6578 6583 6584 6592 6593 6594 6595 6596 6597 6598 6599 6600 6646 6647 6673 6698 6699 6700 
	6701 6702 6703 6704 6705 6706 6707 6708 6709 6710 6711 6712 6713 6714 6715 6716 6717 6718 6719 6720 6721 6722 6723 6724 6725 
	6726 6727 6728 6729 6730 6731 6679
	
	#New VU Additions - American Rivers, Lakes and Sounds
	5926 5927 5928 5929 5930 5931 5932 5933 5934 5961 5962 5963 5964 5965 5966 5967 5968 5941 5942 5943 5944 5945 5946 5947 5948 
	5949 5950 5983 5985 6018 6021 6022 6023 6024 6025 6026 6027 6028 6029 6030 6031 6032 6033 6034 6035 6036 6037 6038 6041 6068 
	6069 6070 6071 6073 6074 6075 6076 6077 6078 6079
	
	#New VU Additions - South East Asia
	6081 6082 6083 6084
	
	#New VU Additions - Caribbean Sea
	6085 6086 6087 6088
	
	#New VU Additions - Amazon
	6108

	#BT Arctic - removed from lakes add to ocean
	1920 1917 1910 1911 1919 2471

	#BT Sea Overhaul (new sea provinces)
	5452 5453 5454 5455 5456 5457 5458 5459 5460 5461 5462 5463 5464 5465 5466 5467 5468 5470 5472 5473 5474 5475 5476 5479 5480 5481 5482 5483 5484 5485 5486 5493 5494 5495

	#Replacing cut provinces above
	8302
}

only_used_for_random = {
	#HR's BtP provinces
	#3004 3005 3006 3007 3008 3009 3010 3011 3012 3013 3014 3015 3016 3017 3018 3019 3020 3021 3022 3023 3024 3025 3026 3027 3028
	#3029 3030 3031 3032 3033 3034 3035 3036 3037 3038 3041 3043 3044 3047 3049 3052 3053
	#3056 3057 3059 3061 3062 3065 3066 3067 3068 3070 3071 3072 3073 3074 3075 3076 3077 3078
	#3079 3080 3081 3082 3083 3084 3085 3086 3087 3088 3089 3090 3091 3093 3094 3096 3097 3098 3100 3101 3102 3103
	#3105 3106 3107 3109 3110 3111 3112 3113 3116 3125 3126 3127 
	#3129 3130 3131 3132 3133 3136 3137 3138 3139 3140 3141 3143 3144 3145 3147 3149 3150 3153
	#3155 3156 3158 3161 3162 3163 3166 3171 3172 3173 3176
	#3184 3186 3188 3189 3299 
	#RNW Sea provinces
	3420 3421 3422 3423 3424 3425 3426 3427 3428 3429 3430 3431 3432 3433 3434 3435 3436 3437 3438 3439 3440 3441 3442 3443 3444 3445 3446 3447 3448 3449 3450 3451 3452 3453 3454 3455 3456 3457 3458 3459 3460 3461 3462 3463 3464 3465 3466 3467 3468 3469 3470 3471 3472 3473 3474 3475 3476 3477 3478 3479 3480 3481 3482 3483 3484 3485 3486 3487 3488 3489 3490 3491 3492 3493 3494 3495 3496 3497 3498 3499

	#HR's BtP provinces
	#RNW Land provinces
	#3191 3192 3205 3208 3210 3211 3212 
	#3215 3216 3217 3218 3228 3232 3233 3234 3235 3236 3237 3239
	#3240
	#3269 3274 3283 3286
	#3296 3298 3299 
	#RNW Land provinces
	3304 3305 3306 3307 3308 3309 3310 3311 3312 3313 3314 3315 3316 3317 3318 3319 3320 3321 3322 3323 3324 3325 3326 3327 3328 3329 3330 3331 3332 3333 3334 3335 3336 3337 3338 3339 3340 3341 3342 3343 3344 3345 3346 3347 3348 3349 3350 3351 3352 3353 3354 3355 3356 3357 3358 3359 3360 3361 3362 3363 3364 3365 3366 3367 3368 3369 3370 3371 3372 3373 3374 3375 3376 3377 3378 3379 3380 3381 3382 3383 3384 3385 3386 3387 3388 3389 3390 3391 3392 3393 3394 3395 3396 3397 3398 3399 3400 3401 3402 3403 3404 3405 3406 3407 3408 3409 3410 3411 3412 3413 3414 3500 3501 3502 3503 3504 3505 3506 3507 3508 3509 3510 3511 3512 3513 3514 3515 3516 3517 3518 3519 3520 3521 3522 3523 3524 3525 3526 3527 3528 3529 3530 3531 3532 3533 3534 3535 3536 3537 3538 3539 3540 3541 3542 3543 3544 3545 3546 3547 3548 3549 3550 3551 3552 3553 3554 3555 3556 3557 3558 3559 3560 3561 3562 3563 3564 3565 3566 3567 3568 3569 3570 3571 3572 3573 3574 3575 3576 3577 3578 3579 3580 3581 3582 3583 3584 3585 3586 3587 3588 3589 3640 3641 3642 3643 3644 3645 3646 3647 3648 3649 3650 3651 3652 3653 3654 3655 3656 3657 3658 3659 3660 3661 3662 3663 3664 3665 3666 3667 3668 3669 3670 3671 3672 3673 3674 3675 3676 3677 3678 3679 3680 3681 3682 3683 3684 3685 3686 3687 3688 3689 3690 3691 3692 3693 3694 3695 3696 3697 3698 3699

	3700 3701 3702 3703 3704 3705 3706 3707 3708 3709 3710 3711 3712 3713 3714 3715 3716 3717 3718 3719	3720 3721 3722 3723 3724 3725 3726 3727 3728 3729 3730 3731 3732 3733 3734 3735 3736 3737 3738 3739	3740 3741 3742 3743 3744 3745 3746 3747 3748 3749 3750 3751 3752 3753 3754 3755 3756 3757 3758 3759	3760 3761 3762 3763 3764 3765 3766 3767 3768 3769 3770 3771 3772 3773 3774 3775 3776 3777 3778 3779	3780 3781 3782 3783 3784 3785 3786 3787 3788 3789 3790 3791 3792 3793 3794 3795 3796 3797 3798 3799

	3800 3801 3802 3803 3804 3805 3806 3807 3808 3809 3810 3811 3812 3813 3814 3815 3816 3817 3818 3819	3820 3821 3822 3823 3824 3825 3826 3827 3828 3829 3830 3831 3832 3833 3834 3835 3836 3837 3838 3839	3840 3841 3842 3843 3844 3845 3846 3847 3848 3849 3850 3851 3852 3853 3854 3855 3856 3857 3858 3859	3860 3861 3862 3863 3864 3865 3866 3867 3868 3869 3870 3871 3872 3873 3874 3875 3876 3877 3878 3879	3880 3881 3882 3883 3884 3885 3886 3887 3888 3889 3890 3891 3892 3893 3894 3895 3896 3897 3898 3899

	3900 3901 3902 3903 3904 3905 3906 3907 3908 3909 3910 3911 3912 3913 3914 3915 3916 3917 3918 3919	3920 3921 3922 3923 3924 3925 3926 3927 3928 3929 3930 3931 3932 3933 3934 3935 3936 3937 3938 3939	3940 3941 3942 3943 3944 3945 3946 3947 3948 3949 3950 3951 3952 3953 3954 3955 3956 3957 3958 3959	3960 3961 3962 3963 3964 3965 3966 3967 3968 3969 3970 3971 3972 3973 3974 3975 3976 3977 3978 3979	3980 3981 3982 3983 3984 3985 3986 3987 3988 3989 3990 3991 3992 3993 3994 3995 3996 3997 3998 3999

	#RNW Wasteland provinces
	3415 3416 3417 3418 3419 3590 3591 3592 3593 3594 3595 3596 3597 3598 3599 3620 3621 3622 3623 3624 3625 3626 3627 3628 3629 3630 3631 3632 3633 3634 3635 3636 3637 3638 3639

	#1.23 provinces
	#4268 4269 4270 4271 4272 4273 4274 4275 4276 4277 4278 4279 4280 4281 4282 4283 4284 4285 4286 4287 4288 4289 4290 4291 4292
	#4293 4294 4295 4296 4297 4298 4299 4300 4301 4302 4303 4304 4305 4306 4307 4308 4309 4310 4311 4312 4313 4314 4315 4316 4317
	#4318 4319 4320 4322 4324 4325 4326 4327 4328 4329 4330 4331 4332 4333 4334 4335 4336 4337 4338 4339 4340 4341 4342
	#4343 4344 4345 4346 4347

	#Things not in override.
	#4270

	#Beyond Typus's Buffer (in case Paradox adds more provinces)

	#Beyond Typus's Second Buffer (in case Paradox adds enough new provinces to start messing with BT's IDs, and I need to start migrating to new IDs. Note the exactly 1000 higher number is intentional for ease of updating)
	6127 6128 6129 6130 6131 6132 6133 6134 6135 6136 6137 6138 6139 6140 6141 6142 6143 6144 6145 6146 6147

	#Removed new Paradox provinces
	4140 4328 4347 #1.23 sea and wastelands
	4657 #1.29 wasteland

	#BTP removed because of new 1.16 Paradox provinces
	3011 3013 3017 3032 3079 3082 3125 3126 3129 3131 3147 3149 3153 3155 3236 3269 3274 3283 3286
	#4110 4111 4112 4113 4114 4115 4116 4117 4118 4119 4120 4121 4122 4123 4124 4125 4126 4127 4128 4129 4373

	#BTP removed in 1.19 because of new Paradox provinces
	3107 3116  3127 3130 3132 3133 3136 3186 3189 3272 3275

	#Removed 1.19 Paradox provinces -Wastelands
	#4141 4142 4143 4144 4145 4146 4147 4148 4149 4150 4152 4158 4163 4164 4165 4166 4171 4173 4174 4175 4176

	#BTP removed in 1.21 because of new Paradox provinces
	3140 3144 3145 3150 3188

	#New 1.22 provinces, not yet added
	#4241 4242 4243 4244 4245 4246 4247 4248 4249 4250 4251 4252 4253 4254 4255 4256 4257 4258 4259 4260 4261
	#4262 4263 4264 4265 4266 4267

	#BTP removed in 1.22 (actually 8.0 for 1.23) because of new Paradox provinces
	3228 3234 3240

	#BTP and BT removed in 1.23 because of new Paradox provinces
	5182 #Levant
	5294 3255 5291 3249 3259 3258 3257 3260 #Armenia
	5230 #Arabia
	5506 #Red Sea

	#BtP and BT provinces removed in 1.25 due to being replaced with new Paradox provinces.
	3004 3007 3010 3012 3016 3018 3020 3021 3022 3023 3024 3025 3026 3027 3029 3030 3031 3033 3035 3057 3059 3062 3067 3072 3074 3076 3078 3080 3086 3093

	#BtP Provinces replaced in 1.27, mostly Poland and Lithuania, few in Romania
	3232 3161 3162 3218 3219 3222 3233 3235 3237 3158

	#BtP Provinces replaced in 1.28
	3097 3096 3098 3300 3094 3298 3101 3102 3103 3105 3299 5098 #Iberia
	5308 #Maghreb
	5564 5562 5566 5568 5570 5571 5569 5831 5829 5828 5842 5062 #New World

	#BtP Provinces replaced in 1.30
	8132 5375 3084 7902 3090 3109 3176 3173 3172 7704 3166 3171 3163 3053 3205 3211 3212 3208 7912 3056 3141 3143 3296 8235 3044 3043 7077 3041 7023 7018 3038 7010 
	7000 3037 3049 3047 7074 7814 7820 7822 3217 7763 3191 3192 3184 7737 7716 7092 3052 5119 #Wastelands? Not sure what to do with.
	7941 7943 3065 3061 3215 3210 7978 3088 8261 7135 7145 5377 5364 789 5379 3216 3106 3100 8046 3090 7726

	#Repurposed BtP provinces
	#3008 
	
	#VU used provinces
	#1801 3039 3040 3042 3045 3046 3048 3050 3051 3054 3055 3058 3060 3063 3064 3069 3092 3095 3099 3104 3108 3114 3115 3117 3118 3119 3120 3121 3122 3123 3124 3128 
	3134 3135 3142 3146 3148 3151 3152 3154 3157 3159 3160 3164 3165 3167 3168 3169 3170 3174 3175 3177 3178 3179 3180 3181 3182 3183 3185 3187 3190 3193 3194 3195 
	3196 3197 3198 3199 3200 3201 3202 3203 3204 3206 3207 3209 3213 3214 3220 3221 3223 3224 3225 3226 3227 3229 3230 3231 3238 3239 3241 3242 3243 3244 3245 3246 
	3247 3248 3250 3251 3252 3253 3254 3256 3261 3262 3263 3264 3265 3266 3267 3268 3270 3271 3273 3276 3277 3279 3280 3281 3282 3284 3285 3290 3291 3292 3293 3294 3295 3297 3301 3302 3303 
	5140 5141 5173 5174 5175 5176 5181 5192 5193 5194 5195 5196 5197 5198 5292 5299 5305 5335 5336 5337 5686 5687 5688 5689 5690 5691 5692 5693 5694 5695 5696 5697 
	5698 5699 5700 5701 5702 5703 5704 5705 5706 5707 5708 5709 5710 5711 5712 5713 5714 5715 5716 5717 5718 5719 5720 5721 5865 5920 5921 5922 5923 5924 5925 5935 
	5936 5937 5938 5939 5940 5951 5952 5953 5954 5955 5956 5957 5958 5959 5960 5969 5970 5971 5972 5973 5974 5975 5976 5977 5978 5979 5980 5981 5982 5984 5986 5987 
	5988 5989 5990 5991 5992 5993 5994 5995 5996 5997 5998 5999 6000 6001 6002 6003 6004 6005 6006 6007 6008 6009 6010 6011 6012 6013 6014 6015 6016 6017 6019 6020 
	6039 6040 6072 6089 6090 6091 6092 6093 6094 6095 6096 6097 6098 6099 6100 6101 6102 6103 6104 6105 6106 6107 6109 6110 6111 6112 6113 6114 6115 6116 6117 6118 
	6119 6120 6121 6122 6123 6124 6125 6126 6174 6175 6176 6177 6178 6179 6180 6181 6182 6183 6184 6185 6186 6187 6188 6189 6190 6191 6192 6193 6194 6195 6196 6197 
	6198 6199 6200 6201 6202 6203 6204 6205 6206 6207 6208 6209 6210 6211 6212 6213 6214 6215 6424 6425 6426 6427 6428 6429 6430 6431 6434 6435 6436 6437 6438 6439 
	6440 6441 6442 6443 6444 6445 6446 6447 6448 6449 6450 6451 6452 6453 6454 6455 6456 6457 6458 6459 6460 6461 6462 6463 6464 6465 6466 6467 6468 6469 6471 6472 
	6473 6474 6475 6476 6477 6478 6479 6480 6481 6482 6483 6484 6485 6486 6487 6488 6489 6490 6491 6492 6493 6494 6495 6496 6497 6498 6499 6500 6501 6502 6503 6504 
	6505 6506 6507 6508 6509 6510 6511 6512 6513 6514 6515 6516 6517 6518 6519 6520 6521 6522 6523 6524 6525 6526 6527 6528 6529 6530 6531 6532 6533 6534 6535 6536 
	6537 6538 6539 6540 6541 6542 6543 6544 6545 6546 6547 6549 6550 6551 6552 6553 6554 6555 6556 6557 6558 6559 6560 6561 6562 6563 6564 6565 6566 6567 6568 6569 
	6570 6571 6572 6573 6574 6575 6576 6580 6581 6582 6585 6586 6587 6588 6589 6590 6591 6602 6603 6604 6605 6606 6607 6608 6609 6610 6611 6612 6613 6614 6615 6616 
	6617 6618 6619 6620 6621 6622 6623 6624 6625 6626 6627 6628 6629 6630 6631 6632 6633 6634 6635 6636 6637 6638 6639 6640 6641 6642 6643 6644 6645 6648 6649 6650 
	6651 6652 6653 6654 6655 6656 6657 6658 6659 6660 6661 6662 6663 6664 6665 6666 6667 6668 6669 6670 6674 6675 6676 6680 6681 6682 6683 6684 6732 6733 6734 6735 
	6736 6737 6738 6739 6740 6741 6742 6743 6744 6745 6746 6747 6748 6749 6750 6751 6752 6753 6754 6755 6756 6757 6758 6759 6760 6761 6762 6763 6764 6765 6766 6767 6768 6769 6770 6771 6772 6773 6774 6775 6776 6777 6778 6779 6780 6781 6782 6783 
	6784 6785 6786 6787 6788 6789 6790 6791 6792 6793 6794 6795 6796 6797 6798 6799 6800 6801 6802 6803 6804 6805 6806 6807 6808 6809 6810 6811 6812 6813 6814 6815 
	6816 6817 6818 6819 6820 6821 6822 6823 6824 6825 6826 6827 6828 6829 6830 6831 6832 6833 6834 6835 6836 6837 6838 6839 6840 6841 6842 6843 6844 6845 6846 6847 
	6848 6849 6850 6851 6852 6853 6854 6855 6856 6857 6858 6859 6860 6861 6862 6863 6864 6865 6866 6867 6868 6869 6870 6871 6872 6873 6874 6875 6876 6877 6878 6879 
	6880 6881 6882 6883 6884 6885 6886 6887 6888 6889 6890 6891 6892 6893 6894 6895 6896 6897 6898 6899 6900 6901 6902 6903 6904 6905 6906 6907 6908 6909 6910 6911 
	6912 6913 6914 6915 6916 6917 6918 6919 6920 6921 6922 6923 6924 6927 6928 6929 6930 6931 6932 6933 6934 6936 6937 6938 6939 6940 6941 6935 6951 6952 6953 6954 
	6955 6957 6958 6959 6960 6961 6962 6963 6964 6965 6966 6967 6968 6969 6971 6972 6973 6974 6975 6976 6977 6978 6979 6980 6981 6982 6983 6984 6985 6998 6999 7160 
	7068 7069 7073 7103 7104 7105 7116 7119 7121 7131 7143 7153 7161 7162 7163 7164 7165 7166 7167 7168 7169 7170 7171 7172 7173 7174 7175 7176 7177 7178 7179 7180 7181 7182 7183 7184 7185 7188 7189 7314 7315 7316 7317 7318 
	7319 7320 7357 7358 7359 7360 7361 7362 7363 7364 7365 7366 7367 7368 7369 7370 7371 7372 7373 7374 7375 7376 7378 7379 7380 7381 7382 7383 7384 7469 7470 7416 
	7417 7418 7419 7420 7421 7422 7423 7424 7425 7426 7427 7428 7429 7430 7431 7432 7433 7434 7435 7436 7437 7438 7439 7440 7441 7442 7443 7444 7445 7446 7447 7448 
	7449 7450 7451 7452 7453 7454 7455 7456 7457 7461 7462 7463 7464 7465 7466 7467 7468 7471 7472 7473 7474 7475 7476 7477 7478 7479 7480 7481 7482 7483 7484 7485 
	7486 7487 7488 7489 7490 7491 7492 7493 7494 7495 7496 7497 7498 7499 7500 7501 7502 7503 7504 7505 7506 7507 7508 7509 7510 7511 7512 7513 7514 7515 7516 7517 
	7518 7519 7520 7521 7522 7523 7524 7525 7526 7527 7528 7529 7530 7531 7532 7533 7534 7535 7536 7537 7538 7539 7540 7541 7542 7543 7544 7545 7546 7547 7548 7549 
	7550 7551 7552 7553 7554 7555 7556 7557 7558 7559 7560 7561 7562 7563 7564 7565 7566 7567 7568 7569 7570 7571 7572 7573 7574 7575 7576 7577 7578 7579 7580 7581 
	7582 7583 7584 7585 7586 7587 7588 7589 7590 7591 7592 7593 7594 7595 7596 7597 7598 7599 7600 7601 7602 7603 7604 7605 7606 7607 7608 7609 7610 7611 7612 7613 
	7614 7615 7616 7617 7618 7619 7620 7621 7622 7623 7624 7625 7626 7627 7628 7629 7630 7631 7632 7633 7634 7635 7636 7637 7638 7639 7640 7641 7642 7643 7644 7645 
	7646 7647 7648 7649 7650 7651 7652 7653 7654 7655 7656 7657 7658 7659 7660 7661 7662 7663 7664 7665 7666 7667 7668 7669 7670 7671 7672 7673 7674 7675 7676 7677 
	7678 7679 7680 7681 7682 7683 7684 7685 7686 7687 7688 7689 7690 7691 7692 7693 7694 7695 7696 7697 7698 7699 7713 8267 8268 8269 8270 8271 8272 8273 8274 8275 8276 
	8277 8278 8279 8280 8281 8282 8283 8284 8285 8286 8287 8288 8289 8290 8291 8292 8293 8294 8295 8296 8297 8298 8299 8430 8431 8432 8433 8434 8435 8436 8437 8438 
	8439 8440 8441 8442 8443 8444 8445 8446 8447 8448 8449 8450 8451 8452 8453 8454 8455 8456 8457 8458 8459 8460 8461 8462 8463 8464 8465 8466 8467 8468 8469 8470 
	8471 8472 8473 8474 8475 8476 8477 8478 8479 8480 8481 8482 8483 8484 8485 8486 8487 8488 8489 8490 8491 8492 8493 8494 8495 8496 8497 8498 8499 8500 8501 8502 
	8503 8504 8505 8506 8507 8508 8509 8510 8511 8512 8513 8514 8515 8516 8517 8518 8519 8520 8521 8522 8523 8524 8525 8526 8527 8528 8529 8530 8531 8532 8533 8534 
	8535 8536 8537 8538 8539 8540 8541 8542 8543
	
	#VU Recycled Provinces
	5090 5099 5132 5133 5136 5148 5149 5153 5159 5160 5166 5169 5179 5183 5199 5202 5204 5234 5236 5237 5238 5240 5242 5245 5247 5248 5252 5253 5254 5257 5258 5259 
	5260 5262 5263 5265 5268 5269 5270 5275 5276

	##################################
	#New Open provinces for Beyond Typus
	##################################
	#Sea Provinces
	8302 8396 8397 8398 8399
	#Wastelands
	5113 5114 5115 5122 5128 8400 8401 8402 8403 8404 8405 8406 8407 8408 8409 8410 8411 8412 8413 8414 8415 8416 8417 8418 8419 8420 8421 8422 8423 8424 8425 8426 8427 8428 8429
	#Middle East
	5142 5143 5144 5338 5339
	#Africa
	5214 5215 5216 5217 
	5429 5430 5431 5432 5433 5434 5435 5436 5437 5438 5439 5440 5441 5442 5443 5444 5445 5446 5447 5448 5449 5450 5451
	#Wastelands
	5546 5547 5548 5549 5550 5551 5552 5553 5554 5555 5556 5557 5558 5559 5560 5561
	#Eastern Europe
	7719 7720 7742
	#SE Europe
	7247 7260 7261 7265

	#Cinnamon Ryce's South East Asia Overhaul
	#8551 8552 8553 8554 8555 8556 8557 8558 8559 8560 8561 8562 8563 8564 8565 8566 8567 8568 8569 8570 8571 8572 8573 8574
	#8575 8576 8577 8578 8579 8580 8581 8582 8583 8584 8585 8586 8587 8588 8589 8590 8591 8592 8593 8594 8595 8596 8597 8598 8599
	#8600 8601 8602 8603 8604 8605 8606 8607 8608 8609 8610 8611 8612 8613 8614 8615 8616 8617 8618 8619 8620 8621 8622 8623 8624
	#8625 8626 8627 8628 8629 8630 8631 8632 8633 8634 8635 8636 8637 8638 8639 8640 8641 8642 8643 8644 8645 8646 8647 8648 8649
	#8650 8651 8652 8653 8654 8655 8656 8657 8658 8659 8660 8661 8662 8663 8664 8665 8666 8667 8668 8669 8670 8671 8672 8673 8674
	#8675 8676 8677 8678 8679 8680 8681 8682 8683 8684 8685 8686 8687 8688 8689 8690 8691 8692 8693 8694 8695 8696 8697 8698 8699
	#8700 8701 8702 8703 8704 8705 8706 8707 8708 8709 8710 8711 8712 8713 8714 8715 8716 8717 8718 8719 8720 8721 8722 8723 8724
	#8725 8726 8727 8728 8729 8730 8731
	#8548 8549
	#Removed from CR's South East Asia Overhaul
	8610 8660 8661 8662 8663 8664 8665 8666

	#12.0's France
	#7889 7890 7891 7892 7893 7894 7895 7896 7897 7898 7899 7900 7901 7902 7903 7904 7905 7906 7907 7908 7909 7910 7911 7912 7913
	#7914 7915 7916 7917 7918 7919 7920 7921 7922 7923 7924 7925 7926 7927 7928 7929 7930 7931 7932 7933 7934 7935 7936 7937 7938
	#7939 7940 7941 7942 7943 7944 7945 7946 7947 7948 7949 7950 7951 7952 7953 7955 7956 7957 7958 7959 7960 7961 7962 7963
	#7964 7965 7966 7967 7968 7969 7970 7971 7972 7973 7974 7975 7976 7977 7978 7979 7980 7981 7982 7983 7984 7985 7986 7987 7988
	#7989 7990 7991 7992 7993 7994 7995 7996 7997 7998 7999 8013 8014 8015 8016 8017 8018 8019 8020 8021 8022 8023 8024 8025 8026
	#8027 8028
	#12.0's Iberia
	#8028 8029 8030 8031 8032 8033 8034 8035 8036 8037 8038 8039 8040 8041 8042 8043 8044 8045 8046 8047 8048 8049
	#8050 8051 8052 8053 8054 8055 8056 8057 8058 8059 8060 8061 8062 8063 8064 8065 8066 8067 8068 8069 8070 8071 8072 8073 8074
	#8075 8076 8077 8078 8079 8080 8081 8082 8083 8084 8085 8086 8087 8088 8089 8090 8091 8092 8093 8094 8095 8096 8097 8098 8099
	#8100 8101 8102 8103 8104 8105 8106 8107 8108 8109 8110 8111 8113 8114 8115 8116 8117

	#Future IDs
	#8720 8721 8722 8723 8724
	#8725 8726 8727 8728 8732 8733 8734 8735 8736 8737 8738 8739 8740 8741 8742 8743 8744 8745 8746 8747 8748 8749
	#8750 8751 8752 8753 8754 8755 8756 8757 8758 8759 8760 8761 8762 8763 8764 8765 8766 8767 8768 8769 8770 8771 8772 8773 8774
	#8775 8776 8777 8778 8779 8780 8781 8782 8783 8784 8785 8786 8787 8788 8789 8790 8791 8792 8793 8794 8795 8796 8797 8798 8799
	#8800 8801 8802 8803 8804 8805 8806 8807 8808 8809 8810 8811 8812 8813 8814 8815 8816 8817 8818 8819 8820 8821 8822 8823 8824
	#8825 8826 8827 8828 8829 8830 8831 8832 8833 8834 8835 8836 8837 8838 8839 8840 8841 8842 8843 8844 8845 8846 8847 8848 8849
	#8850 8851 8852 8853 8854 8855 8856 8857 8858 8859 8860 8861 8862 8863 8864 8865 8866 8867 8868 8869 8870 8871 8872 8873 8874
	#8875 8876 8877 8878 8879 8880 8881 8882 8883 8884 8885 8886 8887 8888 8889 8890 8891 8892 8893 8894 8895 8896 8897 8898 8899
	#8900 8901 8902 8903 8904 8905 8906 8907 8908 8909 8910 8911 8912 8913 8914 8915 8916 8917 8918 8919 8920 8921 8922 8923 8924
	#8925 8926 8927 8928 8929 8930 8931 8932 8933 8934 8935 8936 8937 8938 8939 8940 8941 8942 8943 8944 8945 8946 8947 8948 8949
	#8950 8951 8952 8953 8954 8955 8956 8957 8958 8959 8960 8961 8962 8963 8964 8965 8966 8967 8968 8969 8970 8971 8972 8973 8974
	#8975 8976 8977 8978 8979 8980 8981 8982 8983 8984 8985 8986 8987 8988 8989 8990 8991 8992 8993 8994 8995 8996 8997 8998 8999
	#9000 9001 9002 9003 9004 9005 9006 9007 9008 9009 9010 9011 9012 9013 9014 9015 9016 9017 9018 9019 9020 9021 9022 9023 9024
	#9025 9026 9027 9028 9029 9030 9031 9032 9033 9034 9035 9036 9037 9038 9039 9040 9041 9042 9043 9044 9045 9046 9047 9048 9049
	#9050 9051 9052 9053 9054 9055 9056 9057 9058 9059 9060 9061 9062 9063 9064 9065 9066 9067 9068 9069 9070 9071 9072 9073 9074
	#9075 9076 9077 9078 9079 9080 9081 9082 9083 9084 9085 9086 9087 9088 9089 9090 9091 9092 9093 9094 9095 9096 9097 9098 9099 
}

lakes = {
	1250 1251 1260 1325 1327 1648 1649 1650 1651 1653 1654 1656 1657 1658 1664 1665 1883 1884 1885 1886 1887 1888 1889 1890 1891 1892 1893 1894 1899 1900 1902 1903 1904 1905 1906 1907 1908 1909 1912 1914 1915 1916 1918 1921 1922 1923 2000 2001 2953 4132 4133 4134 4135 4136 4137 4138 4139
	1253 #Finnish Lakes, moved from old E Aland sea
	4235 #Vistula Lagoon

	#BTP New Lakes
	3015 3287 3288 3289 5487 5496 5497 5498 8301

    #VU New Lakes
    1976 4870 4940 4941 5522 6432 6433 6577 6677 6678 6956 6970 7186 7187 7296 7353 7883 7884 8303 8304 8305 8306 8307 8308 8309 8310 8320 8321 8322 8323 8324 8325 8341 8377 8378 8395
	
	#VU New African Lakes
	6396 6397 6398 6399 6400 6401 6402 6403 6404 6405 6406 6407 6408 6409 6410 6411 6412 6413 6414 6415 6416 6417 6418 6419 6420 6421 6422 6423 6685 6686 6687 6688 6689 6690 6691 6692 6693 6694 6695 6696 6697
	
	#VU New Italian Lakes
	6382 6383 6384 6385 6386 6388 6389 6390 6391 6392 6393 6394 6395
	
	#VU Austrian Lakes
	6387
	
	#VU New Anatolian Lakes
	6364 6365 6366 6367 6368 6369 6370 6371 6372 6373 6374 6375 6376 6377 6378 6379 6380 6381
	
	#VU New South American Lakes
	6216 6217 6218 6219 6221 6222 6223 6224 6226 6228 6229 6230 6233 6234 6235 6240 6241 6242 6243 6244 6245 6246 6247 6248 6249 6250 6251 6252 6253 6254 6255 6256 6257 6258 6259 6260 6261 6262 6263 6264 6265 6266 6267 6268 6269 6270 6271 6272 6273 6274 6275 6276 6277 6278 6279 6280 6281 6282 6283 6284 6285 6286 6287 6288 6289 6290 6291 6292
	
	#VU New North American Lakes
	6042 6043 6044 6045 6046 6047 6048 6049 6050 6051 6052 6053 6054 6055 6056 6057 6058 6059 6060 6061 6062 6063 6064 6065 6066 6067
	
	#VU New Indian Lakes
	6080
	
	#BT New Lakes
	5100 5101 5102 5103 5104 5105 5106 5108 5109 5110 5471 5477 5488 5489 5490 5491 5492 5500 5501 5502 5503 5469 5478 5504 5505 8300

	#RNW Lake provinces
	3600 3601 3602 3603 3604 3605 3606 3607 3608 3609 3610 3611 3612 3613 3614 3615 3616 3617 3618 3619 3620 4000 4001 4002 4003 4004 4005 4006 4007 4008 4009 4010 4011 4012 4013 4014 4015 4016 4017 4018 4019

	#Removed Paradox Lakes
	#4140
}

force_coastal = {
}

definitions = "definition.csv"
provinces = "provinces.bmp"
positions = "positions.txt"
terrain = "terrain.bmp"
rivers = "rivers.bmp"
terrain_definition = "terrain.txt"
heightmap = "heightmap.bmp"
tree_definition = "trees.bmp"
continent = "continent.txt"
adjacencies = "adjacencies.csv"
climate = "climate.txt"
region = "region.txt"
superregion = "superregion.txt"
area = "area.txt"
provincegroup = "provincegroup.txt"
ambient_object = "ambient_object.txt"
seasons = "seasons.txt"
trade_winds = "trade_winds.txt"
canal_definition = {
	name = "panama_canal"
	x = 1317
	y = 1082
}
canal_definition = {
	name = "suez_canal"
	x = 3111
	y = 1454
}
canal_definition = {
	name = "second_suez_canal"
	x = 3094
	y = 1489
}
canal_definition = {
	name = "kiel_canal"
	x = 2756
	y = 1903
}
canal_definition = {
	name = "don_and_volga_canal"
	x = 3295
	y = 1787
}
canal_definition = {
	name = "ludwig_canal"
	x = 2745
	y = 1779
}

canal_definition = {
	name = "kra_canal"
	x = 4151
	y = 1127
}

# Define which indices in trees.bmp palette which should count as trees for automatic terrain assignment
tree = { 3 4 7 10 }
